က = k
ခ = kh
ဂ = g
ဃ = gh
င = ng
စ = s
ဆ = ss
ဇ = z
စ် = zh
ည = ny
ၫ = ny
ဉ = ny
ဋ = tt
ဍ = dh
ဌ = ht
႒ = ht
ဠ = n
ဎ = d
ဏ = nh
တ = t
ထ = ht
ဒ = d
ဓ = dh
န = n
ႏ = n
ပ = p
ဖ = ph
ဗ = v
ဘ = b
မ = m
ယ = yh
ရ = y
႐ = y
လ = l
ဝ = w
သ = th
ဟ = h
အ = a
ဥ = o
ရွ = sh
သွ် = sh
လွ် = sh
ရႊ = shw
